6,6,6,6,6,6,6
6,2,1,1,1,2,6
6,1,1,1,1,1,6
6,1,1,1,1,1,6
6,4,1,2,1,1,6
6,1,1,1,1,1,6
6,1,1,1,1,1,6
6,2,1,1,1,2,6
6,6,6,6,6,6,6
