5,4,4,4,4,4,4,4,4,4,4,4,4,4,4,4,4,4,4,4,4,4,4,4,4,4,4,4,4,4,4,4,4,4,4,4,4,4,4,4,4,4,4,4,4,4,4,4,4,6
3,1,1,1,1,1,1,1,1,1,1,1,1,1,1,1,1,2,1,1,2,5,4,4,4,4,4,4,6,2,1,1,1,5,6,1,1,1,2,5,4,1,1,1,1,2,2,9,2,3
3,1,5,4,4,4,2,4,4,4,2,4,4,4,4,6,1,3,1,3,1,3,2,4,4,4,4,6,3,2,1,2,1,3,3,1,3,1,2,8,4,1,4,6,1,2,1,1,1,3
3,1,3,1,1,1,3,1,1,1,3,1,1,1,2,3,1,3,1,3,1,8,4,4,4,4,4,7,3,2,1,2,1,3,3,1,3,1,2,2,2,1,1,3,1,2,1,1,1,3
3,1,3,1,3,1,3,1,3,1,3,1,2,1,3,3,1,3,1,3,1,1,1,1,1,1,1,1,3,2,1,2,1,3,3,1,3,1,1,1,1,6,1,3,1,2,1,1,1,3
3,1,1,1,3,1,1,1,3,1,1,1,3,1,3,3,1,3,1,8,4,4,4,4,4,6,2,1,8,6,2,2,1,3,3,1,8,4,4,6,1,3,1,3,1,2,1,1,1,3
3,2,2,4,2,4,4,4,2,4,4,4,2,1,3,3,1,3,1,1,1,1,1,1,1,8,6,1,1,3,1,1,1,3,3,1,1,1,1,3,1,3,1,3,1,2,2,1,2,3
3,1,1,1,1,1,1,1,1,1,1,1,3,1,3,3,1,8,4,4,4,4,4,4,1,1,1,6,1,3,1,5,4,7,8,4,4,6,1,3,1,3,1,3,1,4,4,1,6,3
3,1,3,2,2,2,2,2,2,2,2,1,1,1,3,3,1,1,1,1,1,1,1,1,8,6,1,3,1,3,1,8,6,5,4,4,4,7,1,3,1,1,1,3,1,1,1,1,3,3
3,1,3,1,1,1,1,1,1,1,2,2,2,2,3,8,4,4,4,4,4,4,6,1,5,7,1,3,1,3,1,1,3,8,4,4,4,4,1,7,2,2,2,8,4,4,4,4,7,3
3,1,3,1,2,2,2,2,2,1,2,2,2,2,3,2,2,2,2,2,2,2,3,1,3,1,1,7,1,3,2,1,8,4,4,4,4,2,1,1,1,1,1,1,1,1,1,1,1,3
3,1,8,1,4,4,4,4,4,1,4,4,4,4,7,2,5,4,4,4,4,2,3,1,3,1,3,1,1,8,4,1,4,4,4,4,4,4,4,4,4,4,4,4,4,4,6,2,1,3
3,1,1,1,2,2,2,2,2,1,2,2,2,2,2,2,3,1,1,1,1,2,3,1,3,1,3,1,5,6,2,1,1,1,1,1,1,1,1,1,1,1,1,1,1,1,3,3,1,3
3,5,4,6,5,4,4,4,6,1,5,4,4,4,4,4,7,1,5,6,1,2,3,1,3,1,3,1,8,4,4,4,4,4,4,4,4,4,4,4,4,4,4,4,6,1,8,7,1,3
3,3,1,3,2,1,1,1,3,1,3,1,1,1,1,1,1,1,2,3,1,2,3,1,3,1,3,1,1,1,1,1,1,1,1,1,1,1,1,1,1,1,1,1,3,1,1,1,1,3
3,3,1,3,2,1,2,1,3,1,3,1,5,4,4,4,4,4,4,7,1,2,3,1,3,1,2,4,4,4,4,4,4,4,4,4,4,4,4,4,4,4,6,1,8,4,4,2,1,3
3,3,1,3,2,1,5,1,7,1,2,1,3,1,1,1,1,1,1,1,1,2,3,1,3,1,3,1,1,1,1,1,1,1,1,1,1,1,1,1,1,1,3,1,1,1,1,1,1,3
3,3,1,1,1,1,3,1,1,1,1,1,3,1,2,4,4,4,4,4,4,2,3,1,3,1,3,1,5,4,4,4,4,4,4,4,4,4,4,4,6,1,8,4,4,4,4,6,1,3
3,3,1,3,5,6,8,4,4,4,4,4,7,1,1,1,1,1,1,1,1,2,3,1,3,1,3,1,3,1,1,1,2,1,1,1,2,1,1,1,3,1,1,2,4,4,4,7,1,3
3,3,1,3,3,8,4,4,4,4,4,4,4,4,4,4,4,4,4,6,1,2,3,1,3,1,3,1,1,1,2,1,1,1,2,1,1,1,2,1,3,2,1,1,1,1,1,1,1,3
3,8,4,7,3,1,1,1,1,1,1,1,1,1,1,1,1,1,1,3,1,2,3,1,3,1,8,4,4,4,4,4,4,2,4,4,4,4,6,1,8,4,4,4,4,4,4,6,1,3
3,2,4,4,7,1,5,4,4,4,4,4,4,4,4,4,4,6,1,3,1,2,3,1,3,1,1,1,1,1,1,1,1,3,1,1,1,1,3,1,1,1,1,1,1,1,1,3,1,3
3,1,1,1,1,1,3,1,1,1,1,1,1,1,1,1,1,3,1,3,1,2,3,1,8,4,2,4,4,4,4,6,1,3,1,4,6,1,8,4,4,4,4,4,4,2,1,3,1,3
3,1,2,4,4,4,7,1,5,4,4,4,4,4,4,2,1,3,1,1,1,1,3,1,1,1,3,1,1,1,1,3,1,3,1,1,3,1,1,1,1,1,1,1,1,1,2,3,1,3
3,1,1,1,1,1,1,1,3,1,1,1,1,1,1,1,1,8,6,2,2,1,8,4,6,1,8,4,4,6,1,3,1,8,4,1,3,4,4,4,4,4,4,4,4,4,4,2,1,3
3,5,4,4,4,4,4,4,7,1,2,4,4,4,4,4,4,4,7,1,3,1,1,1,3,1,1,1,1,3,1,3,1,1,1,1,8,4,4,4,4,4,4,4,4,4,4,2,1,3
3,8,6,1,1,1,1,1,1,1,1,1,1,1,1,1,1,1,1,1,8,4,6,1,8,4,4,6,1,3,1,1,1,1,1,1,1,1,1,1,1,1,1,1,1,1,1,3,1,3
3,2,3,1,5,4,4,4,4,4,4,4,4,4,4,4,4,4,4,4,4,4,7,1,1,1,1,3,1,8,4,4,4,4,4,4,4,4,4,4,4,4,4,4,4,4,1,3,1,3
3,8,7,1,3,2,4,4,4,4,4,4,4,4,4,4,4,4,4,4,4,4,4,4,4,6,1,3,1,1,1,1,1,1,1,1,1,1,1,1,1,1,1,1,1,1,1,3,1,3
3,1,1,1,3,1,1,1,1,1,1,1,1,1,1,1,1,1,1,1,1,1,1,1,1,3,1,8,4,4,4,6,1,2,2,4,4,2,4,4,2,4,4,2,4,4,4,7,1,3
3,1,5,4,7,1,5,4,4,4,2,4,4,4,2,4,4,4,2,4,4,4,4,6,1,3,1,1,1,1,1,3,1,1,1,1,1,1,1,1,1,1,1,1,1,1,1,1,1,3
3,1,3,5,6,1,3,1,1,1,3,1,1,1,3,1,1,1,3,1,1,1,1,3,1,8,4,4,4,6,1,3,1,5,4,4,4,2,4,4,4,2,4,4,4,2,4,4,4,3
3,1,3,3,3,1,3,1,3,1,3,1,3,1,3,1,3,1,3,1,5,4,1,3,1,1,1,1,1,3,1,3,1,3,1,1,1,3,1,1,1,3,1,1,1,3,1,1,1,3
3,1,3,2,3,1,3,1,3,1,3,1,3,1,3,1,3,1,3,1,3,1,1,2,4,4,4,6,1,3,1,3,1,1,1,3,1,1,1,3,1,1,1,3,1,1,1,2,1,3
3,1,8,4,7,1,1,1,3,1,1,1,3,1,1,1,3,1,1,1,3,1,4,7,1,1,5,7,1,3,1,2,4,4,4,2,4,4,4,2,4,4,4,2,4,4,4,2,1,3
3,1,1,1,1,1,5,4,4,4,4,6,2,5,4,4,2,2,4,4,7,1,1,1,1,5,7,1,1,3,1,3,1,1,1,1,1,1,1,1,1,1,1,1,1,1,1,1,1,3
3,1,1,4,4,4,7,1,1,1,1,8,4,2,1,1,1,3,1,1,1,5,4,4,4,2,6,1,5,7,1,3,1,4,4,2,4,4,4,2,4,4,4,2,4,4,4,6,3,3
3,1,1,1,1,1,1,1,5,6,1,1,1,3,1,3,1,1,1,3,1,3,1,1,1,1,3,1,8,6,1,3,1,1,1,3,1,1,1,3,1,1,1,3,1,1,1,8,7,3
3,1,5,4,4,4,4,4,7,8,4,6,1,1,1,8,4,4,4,2,1,1,1,5,6,1,3,1,1,3,1,8,4,6,1,1,1,3,1,1,1,3,1,1,1,3,1,1,1,3
3,1,3,1,1,1,1,1,1,1,1,8,4,4,6,1,1,1,1,2,4,4,4,7,3,1,8,6,1,3,1,5,4,7,4,2,4,2,4,2,4,2,4,2,4,2,4,6,1,3
3,1,3,1,5,4,4,4,6,2,1,1,1,1,2,1,5,6,1,3,1,1,1,1,3,1,5,7,1,3,1,3,1,1,1,3,1,1,1,3,1,1,1,3,1,1,1,3,1,3
3,1,3,1,2,1,1,1,8,4,4,6,2,1,1,1,4,7,1,3,1,2,6,1,3,1,3,1,1,3,1,3,1,3,1,1,1,3,1,1,1,3,1,1,1,3,1,1,1,3
3,1,3,1,1,1,2,1,1,1,1,8,4,4,4,7,2,1,1,3,1,1,3,1,3,1,3,1,4,2,1,3,1,8,4,4,4,2,2,4,4,2,4,4,2,2,4,4,4,3
3,1,3,2,4,4,4,4,4,6,1,1,1,1,1,1,3,1,5,7,2,1,3,1,3,1,3,1,1,3,1,3,1,1,1,1,1,1,3,1,1,1,1,1,3,1,1,1,1,3
3,1,3,1,1,1,1,1,2,8,4,4,4,4,4,1,3,1,3,1,1,1,3,1,3,1,8,6,1,3,1,3,5,4,4,4,6,1,1,1,4,4,6,1,1,1,4,6,1,3
3,1,2,4,4,4,6,1,1,1,1,1,1,1,1,1,3,1,3,1,5,4,7,1,3,1,1,3,1,3,1,2,7,1,1,1,8,4,4,7,1,1,1,4,4,7,1,3,1,3
3,1,3,1,1,1,8,2,4,4,4,2,4,4,2,1,3,1,3,1,3,1,1,1,2,2,1,3,1,3,1,3,1,1,3,1,1,1,1,1,1,3,1,1,1,1,1,3,1,3
3,2,8,1,6,1,1,3,1,1,1,3,1,1,1,1,3,1,2,1,8,1,4,4,7,1,1,3,1,3,1,3,1,4,2,4,4,4,4,4,4,2,4,4,4,4,4,7,1,3
3,1,1,1,8,4,1,1,1,2,1,1,1,4,4,4,7,1,1,1,2,1,1,1,1,1,4,7,1,1,1,2,1,1,1,1,1,1,1,1,1,1,1,1,1,1,1,1,1,3
8,4,4,4,4,4,4,4,4,4,4,4,4,4,4,4,4,4,4,4,4,4,4,4,4,4,4,4,4,4,4,4,4,4,4,4,4,4,4,4,4,4,4,4,4,4,4,4,4,7
